1111111111111111111111111111111111111111111
101000000000000C00000C0000000111V01100000E1
1010010100100000101001000000011VVVV10010101
1010010010101010001001000000001111100010101
1P00E0000C00C0000E00000E00000000000C0000001
10100000000V000C00000C0000000000000000V00E1
1010010100100000101001000000010100000000001
1010010010101010001001000000010100000000001
10100000V000000C00000C0000000000E0000000001
101001010010000010100100000V010100000000001
1010010010101010001001000000010100000000001
1111111111111111111111111111111111111111111