1111111111111
100100000P011
10C0011111001
1000110E00001
1111111111111