111111111111111111111111111111111111111
100C100C100C100C100C100C100C100C100C101
1E100C100C100C100C100C100C100C100C100C1
111111111111111111111111111111111111101
100C100C100C100C100C100C100C100C100C101
1C100C100C100C100C100C100C100C100C100C1
100000000000000000000000000000000000011
100C100C100C100C100C100C100C100C100C101
1C100C100C100C100C100C100C100C100C100C1
111111111111111111111111111111111111101
100C100C100C100C100C100C100C100C100C101
1C100C100C100C100C100C100C100C100C100C1
100000000000000000000000000000000000011
100C100C100C100C100C100C100C100C100C101
1C100C100C100C100C100C100C100C100C100C1
110000000000000000000000000000000000101
100C100C100C100C100C100C100C100C100C101
1C100C100C10PC100C100C100C100C100C100C1
111111111111111111111111111111111111111